.............!@.....
......!.............
....................
###..#@#..####......
....................
..............@.....
#.#######.##..###...